	AA	Afar
	AB	Abjaso (o abjasiano)
	AE	Avéstico
	AF	Afrikaans
	AK	Akano
	AM	Amárico
	AN	Aragonés
	AR	Árabe
	AS	Asamés
	AV	Avar
	AY	Aimara
	AZ	Azerí
	BA	Baskir
	BE	Bielorruso
	BG	Búlgaro
	BH	Bhojpurí
	BI	Bislama
	BM	Bambara
	BN	Bengalí
	BO	Tibetano
	BR	Bretón
	BS	Bosnio
	CA	Catalán
	CE	Checheno
	CH	Chamorro
	CO	Corso
	CR	Cree
	CS	Checo
	CU	Eslavo eclesiástico antiguo
	CV	Chuvasio
	CY	Galés
	DA	Danés
	DE	Alemán
	DV	Maldivo
	DZ	Dzongkha
	EE	Ewe
	EL	Griego (moderno)
	EN	Inglés
	EO	Esperanto
	ES	Español (o castellano)
	ET	Estonio
	EU	Euskera
	FA	Persa
	FF	Fula
	FI	Finés (o finlandés)
	FJ	Fiyiano (o fiyi)
	FO	Feroés
	FR	Francés
	FY	Frisón (o frisio)
	GA	Irlandés (o gaélico)
	GD	Gaélico escocés
	GL	Gallego
	GN	Guaraní
	GU	Guyaratí (o guyaratí)
	GV	Manés (gaélico manés o de Isla de Man)
	HA	Hausa
	HE	Hebreo
	HI	Hindi (o hindú)
	HO	Hiri motu
	HR	Croata
	HT	Haitiano
	HU	Húngaro
	HY	Armenio
	HZ	Herero
	IA	Interlingua
	ID	Indonesio
	IE	Occidental
	IG	Igbo
	II	Yi de sichuán
	IK	Inupiaq
	IO	Ido
	IS	Islandés
	IT	Italiano
	IU	Inuktitut
	JA	Japonés
	JV	Javanés
	KA	Georgiano
	KG	Kongo
	KI	Kikuyu
	KJ	Kuanyama
	KK	Kazajo (o kazajio)
	KL	Groenlandés (o kalaallisut)
	KM	Camboyano (o jemer)
	KN	Canarés
	KO	Coreano
	KR	Kanuri
	KS	Cachemiro
	KU	Kurdo
	KV	Komi
	KW	Córnico
	KY	Kirguís
	LA	Latín
	LB	Luxemburgués
	LG	Luganda
	LI	Limburgués
	LN	Lingala
	LO	Lao
	LT	Lituano
	LU	Luba-katanga
	LV	Letón
	MG	Malgache (o malagasy)
	MH	Marshalés
	MI	Maorí
	MK	Macedonio
	ML	Malayalam
	MN	Mongol
	MR	Maratí
	MS	Malayo
	MT	Maltés
	MY	Birmano
	NA	Nauruano
	NB	Noruego bokmål
	ND	Ndebele del norte
	NE	Nepalí
	NG	Ndonga
	NL	Neerlandés (u holandés)
	NN	Nynorsk
	NO	Noruego
	NR	Ndebele del sur
	NV	Navajo
	NY	Chichewa
	OC	Occitano
	OJ	Ojibwa
	OM	Oromo
	OR	Oriya
	OS	Osético
	PA	Panyabí (o penyabi)
	PI	Pali
	PL	Polaco
	PS	Pastú (o pashto)
	PT	Portugués
	QU	Quechua
	RM	Retorrománico
	RN	Kirundi
	RO	Rumano
	RU	Ruso
	RW	Ruandés
	SA	Sánscrito
	SC	Sardo
	SD	Sindhi
	SE	Sami septentrional
	SG	Sango
	SH	Serbocroata
	SI	Cingalés
	SK	Eslovaco
	SL	Esloveno
	SM	Samoano
	SN	Shona
	SO	Somalí
	SQ	Albanés
	SR	Serbio
	SS	Suazi (swati o siswati)
	ST	Sesotho
	SU	Sundanés
	SV	Sueco
	SW	Suajili
	TA	Tamil
	TE	Telugú
	TG	Tayiko
	TH	Tailandés
	TI	Tigriña
	TK	Turcomano
	TL	Tagalo
	TN	Setsuana
	TO	Tongano
	TR	Turco
	TS	Tsonga
	TT	Tártaro
	TW	Twi
	TY	Tahitiano
	UG	Uigur
	UK	Ucraniano
	UR	Urdu
	UZ	Uzbeko
	VE	Venda
	VI	Vietnamita
	WL	Walisiano
	VO	Volapük
	WA	Valón
	WO	Wolof
	XH	Xhosa
	YI	Yídish (o yiddish)
	YO	Yoruba
	ZA	Chuan (o zhuang)
	ZH	Chino
	ZU	Zulú

